NO ./textures/coalish1.xpm
SO ./textures/coalish2.xpm
EA ./textures/coalish3.xpm
WE ./textures/coalish4.xpm
C 0,185,187
F 41,45,57

11111111111111111                   11111111111111111             11111111111111111111111111111111111111111111111111111
1000000S000000001                   10000000000000001             10000000000000000000000000000000000000000000000000001
10000000000000001                   10000000000000001             10000000000000000000000000000000000000000000000000001
10000000000000001                   10000000000000001             10000000000000000000000000000000000000000000000000001
10000000000000001                   10000000000000001             10000000000000000000000000000000000000000000000000001
10000000000000001                   10000000000000001             10000000000000000000000000000000000000000000000000001
10000000000000001                   10000000000000001             10000000000000000000000000000000000000000000000000001
10000000000000001                   10000000000000001             10000000000000000000000000000000000000000000000000001
10000000000000001                   10000000000000001             10000000000000000000000000000000000000000000000000001
10000000000000001                   10000000000000001             10000000000000000000000000000000000000000000000000001
10000000000000001                   10000000000000001             10000000000000000000000000000000000000000000000000001
10000000000000001                   10000000000000001             10000000000000000000000000000000000000000000000000001
10000000000000001                   10000000000000001             10000000000000000000000000000000000000000000000000001
10000000000000001                   10000000000000001             11111111111111111111111111111111111110000000000000001
10000000000000001                   10000000000000001                                                 10000000000000001
10000000000000001                   10000000000000001                                                 10000000000000001
10000000000000001                   10000000000000001                                                 10000000000000001
10000000000000001                   10000000000000001                                                 10000000000000001
10000000000000001                   10000000000000001                                                 10000000000000001
10000000000000001                   10000000000000001                                                 10000000000000001
10000000000000001                   10000000000000001                                                 10000000000000001
10000000000000001                   10000000000000001                                                 10000000000000001
10000000000000001                   10000000000000001                                                 10000000000000001
10000000000000001                   10000000000000001                                                 10000000000000001
10000000000000001111111111111111111110000000000000001111111111111111111111111111111111111111111111111110000000000000001
10000000000000000000000000000000000000000000000000000000000000000000000000000000000000000000000000000000000000000000001
10000000000000000000000000000000000000000000000000000000000000000000000000000000000000000000000000000000000000000000001
10000000000000000000000000000000000000000000000000000000000000000000000000000000000000000000000000000000000000000000001
10000000000000000000000000000000000000000000000000001111111111111110000000000000000000000000000000000000000000000000001
10000000000000000000000000000000000000000000000000001             10000000000000000000000000000000000000000000000000001
10000000000000000000000000000000000000000000000000001             10000000000000001111111111111111111111111111111111111
11111111111111111111111111111111111110000000000000001             10000000000000001
                                    10000000000000001             10000000000000001
                                    10000000000000001             10000000000000001
                                    10000000000000001             10000000000000001
                                    10000000000000001             10000000000000001
                                    10000000000000001             10000000000000001
                                    10000000000000001             10000000000000001
                                    10000000000000001             10000000000000001
                                    10000000000000001             10000000000000001
                                    10000000000000001             10000000000000001
                                    10000000000000001             10000000000000001
                                    10000000000000001             10000000000000001111111111111111111111111111111111111
                                    10000000000000001             10000000000000000000000000000000000000000000000000001
                                    10000000000000001             10000000000000000000000000000000000000000000000000001
                                    10000000000000001             10000000000000000000000000000000000000000000000000001
                                    10000000000000001             10000000000000000000000000000000000000000000000000001
                                    10000000000000001             10000000000000000000000000000000000000000000000000001
                                    10000000000000001             10000000000000000000000000000000000000000000000000001
                                    10000000000000001             10000000000000000000000000000000000000000000000000001
                                    10000000000000001             10000000000000000000000000000000000000000000000000001
                                    10000000000000001             10000000000000000000000000000000000000000000000000001
                                    10000000000000001             10000000000000000000000000000000000000000000000000001
                                    10000000000000001             10000000000000000000000000000000000000000000000000001
                                    10000000000000001             10000000000000000000000000000000000000000000000000001
                                    11111111111111111             11111111111111111111111111111111111111111111111111111