NO ./textures/funky.xpm
SO ./textures/lava.xpm
EA ./textures/east.xpm
WE ./textures/west.xpm
C 127,30,0
F 0,30,127

        111111111111111111111111
        1000000000110000000000001
        1011000001110000000000001
        1001000000000000000000001
111111111011000001110000000000001
1000000000110000011101111111111011111111111
1111011111111101110000001000100000000000001
1111011111111101110101001000100000000000001
0100000011010101110000000000100000000000001
10000000000000001100000010000100000000000001
10000000000000001101010010000000000S0000001
11000001101010111110111100011100000000000001
11110111 1110101 10111101000100000000000001
11111111 1111111 11111111111111111111111111
