NO ./textures/coalish1.xpm
SO ./textures/coalish2.xpm
EA ./textures/coalish3.xpm
WE ./textures/coalish4.xpm
C 0,185,187
F 41,45,57

111111111111111111111111111
100000000000000000000000001
1000000000000N0000000000001
100000000000000000000000001
100000001111111111100000001
100000001000000000100000001
100000001000000000100000001
100000001111101111100000001
100000000000000000000000001
100000000000000000000000001
111111111111111111111111111