NO ./textures/wolf1.xpm

SO ./textures/wolf2.xpm

EA ./textures/wolf3.xpm

WE ./textures/wolf4.xpm

C 56,56,56

F 113,113,113

        111111111                           1111111111111111111111
       11111111111         111111111111111111100000000000000000011111111
       11100000111        1111111111111111111100000000000000000011000011
       111000000111       1110000000000000000000000000000000000000000011
       111110111111111111 1110000111111111111100000000000000000011111111
       1111101111111111111111000111111111111110000000000000000001111111
       1110000000000000111111000011111        11111111000111111111
       1110000000000000000000000000011             110000111
       1110000000000000110000000000011             110000011
11111111110000000000000111111111111111             110000111
1100011111111100011111111                          110000111
110000111111111101111111                  111111111110000011111
111011110000110000111                     110001111110000011111
110001111111110000111                     110000000000000111
110000110000110000111                     111011111110000111
110000110000110000111                      11111111110000111
1100001111111111011111111                          111001111
11000011111111100011111111              111111111110000000111111111111
11000011110000000000000111              1110000000000000000000000001111
11000011110000000000000111              11100000000000000000000000011
11000000000000000000000111              1110E000000000000000000000001
11000001110000000000000111              11100000000000000000000000001
11000011110000000000000111              11100000000000000000000000011111
11000011110000000000000111              11111111111100000001111111111111
11000011111111110111111111               11111111111110000111111
1100001111111110001111                               100001
110000111111110000111                                100001
110000110000110000111                                100001
110000110000110000111                                100001
110000111111110000111111111111111111111              100001
11000011111111000001111111111111111111111111111111111100001
11000000000000000000000000000000000000000000000000000000111111
110000000000000000000000011111000011011111111111111111111
1111111111111111111001110011111111111111
              1111100111001110111
              11111001110011111
                 1110000011111
                  111000111
                  11111111
                   111111

